s#...#...#...##
...#...###.#..#
.##..##.#...#..
.#####.....#..#
...####.#..#...
#.##.#..#####.#
#.##..#...#...#
#..#.#..##..#..
..#..#.####..##
....##..#.##.##
.##..##...##..#
..####..###....
#.#.#..###..##.
#...##..#...#.#
###....###....e
